



         


XXXXXXXXX
XXXXXXXXccc
fggdfgdgd     hjgh
        k


        1111111111111111111111111
XXXXXXXX
     1111000E00001111000001111   
111111111101000101111111
111110000001010100000001
        
101110111101010101110101
100000100001000100000001
101111101111011111101111
100000100000010000100001
101111111011011011111101
100000001010101000000001
101111111010101011111101
100000000000000000000001
111111111111111111111111