NO ./textures/test.png

SO ./textures/test.png

WE  ./textures/test.png

   EA ./textures/test.png


   C 100,149,237

F 107,142,35

 1111
1000001
100W001
1010001
 11111 