NO ./textures/StoneWall/wall1.png
SO ./textures/StoneWall/wall2.png

WE  ./textures/StoneWall/wall3.png

   EA ./textures/StoneWall/wall4.png


   C 135,206,235
F 139,69,19

 11111
10S0001
10001111
1010001
 11111
