NO ./textures/test.png

SO ./textures/test.png

WE  ./textures/test.png

   EA ./textures/test.png


   C 135,206,235
F 139,69,19

 11111
10S0001
1000001
1010001
 11111
