NO ./textures/test.png

WE  ./textures/test.png

   EA ./textures/test.png   

SO ./textures/test.png

C 1,2,3

F 107,142,35


                  111111111111111111111111
1000000000l0111100000001
11101111110100010          1111111
100010000001010100000001
101110111101010101110101
100000100001000100         000001
101111111111011111101111
1000001000000        10000100001
101111111011011011111101         
10000000101010100000001
1011111110101010111        11101
     100000000000000000000001
               1111111111111111111     11111