NO textures/Lumon_case/North.png

SO textures/Lumon_case/South.png

WE  textures/Lumon_case/West.png

   EA textures/Lumon_case/East.png


   C 255,255,245

F 107,142,35




111111111111111   1111111111
1E0000000001001   1000000001
1111111110B10111111C01111C11
    101000001000010000001111111
    1C101110111011101110100A01
    1010000000K0000010000000111
    100010101100111000011111111
1111101000000C0001010101
10101A1011100111011111C1
1010000010000100001X0001
111B10111001011111111101
  10000000B00000000000011   111111
  11111001111111111001111   1A0001
      1111      100011111111100111
                10C0000000000001
                1111111111111111