NO textures/Lumon_case/North.png

SO textures/Lumon_case/South.png

WE  textures/Lumon_case/West.png

   EA textures/Lumon_case/East.png


   C 255,255,245

F 107,142,35

111111111111111111111111
1000000E00001111A0000001
111011111101000101111111
100C100000K1B10100000001
101110111101010101110101
10000A100001000100000001
101111101111011111101111
100000100000B10000100001
101111111A11011C11111101
100000001010101C000000A1
101111111010101011111101
1X0000000000000000000001
111111111111111111111111
