NO textures/Lumon_case/North.png

SO textures/Lumon_case/South.png

WE  textures/Lumon_case/West.png

   EA textures/Lumon_case/East.png


   C 255,255,245

F 107,142,35

      1111                         11111111
      1111        11111111         10010001
       1011111    111000011      1111000101
        110001   1100C01101      1100000101
         11A111111100000011     11001111111
          1010110011A11011111   100011
         11000000011011001001   101011111
         1110B011001101011011  1101;;;;;1
           101101011100011101111001;;;;;1111
           100X01111001111110000011;;0;;1001
           1E000K01100011  10111001;;;;;1001
           11110110001001  101110111011111011
             1000C0101111  101101110000B00001
             1110000001    100111110111111111
               111100111   1100110001
                  110001    1100111011
      1111111111   11011     11001000111111
      100001010111110C0111   10011100011001
      10011101000000000001   10011100010001
      110000B001111111110111110000011000111
       111111111       1001100010000000111
                       11000011111101011
                       1111111 11000111   11111
                               1111011    10001
                               1000001111110001
                               100000000000C111
                               111111111111111

             
