NO textures/Lumon_case/North.png

SO textures/Lumon_case/South.png

WE  textures/Lumon_case/West.png

   EA textures/Lumon_case/East.png


   C 255,255,245

F 107,142,35

      1111                         11111111
      1111        11111111         10011001
       1011111    111000011      1111000001
        110001   1100001101      1000000101
         110111111100000011     11001111111
          1010110011111011111  110011
         11000000011011001001  100111111111
         11100011001101011011  110111000001
           10110101110001110111100111000001111
          110000111100111111011001001000001001
          1E0000001000011110011000110000010001
          111101100110101  1011101111011111011
             100001101111  101101110000100001
             1110000001    100111110111111111
               111100111   1100110001
                  110001    1100111011
      1111111111   11011     11001000111111
      10000101011111000111   10011100011001
      10011101000000000001   10011100010001
      1100000001111111110111110000011000111
       111111111       1001100011100000111
                       11000011111101101
                       11111111111111111
                                